1 А
mother tongue - родной язык
learner - ученик
fluency or accuracy - беглость или точность
bilingual - двуязычный
advantages - преимущества

2
silent letters - непроизносимые
spelt - пишуться, писать
spelling - правописание
watch out - остерегаться

текст
shouts - кричит
lay the table - накрыть стол
tune - мелодия, напев
take our places - заняли наши места
retired - выходить на пенсию
picked up - подчерпнули
adult - взрослый
multilingual - многоязычными
recent research suggests - недавнии иследования показывают
benefit - выгода, преимущество
persistent myths - постоянные мифы
In Nigeria alone - только в нигерии
fortunate in this respect - повезло в этом деле
acquire - приобретать, покупать
fluent and accurate - беглые и точные
concerns - затрагивает
split personalities - раздвоение личности
according o where I am and who I'm with - в зависимости где я и кто я
I'm grateful - я доволен